3 3 3 3 3 3 3 3 3 3 3 3 3 3 3 3 3 3 3 3 3 3 5 5 5 5 5 5 5 5
3 3 3 3 3 0 0 0 0 0 0 0 0 0 0 0 0 0 0 3 3 3 3 5 5 5 5 5 5 5
3 3 3 3 3 0 0 0 0 0 0 0 0 0 0 0 0 0 0 3 3 3 3 3 5 5 5 5 5 5 
3 3 3 3 3 4 0 0 0 0 0 0 0 0 0 0 0 0 0 3 3 3 3 3 3 5 5 5 5 5
3 3 3 3 3 4 0 0 0 0 0 0 0 2 0 0 0 0 0 3 3 3 3 3 3 3 5 5 5 5
3 3 3 3 3 0 0 0 0 0 0 0 0 2 2 0 0 0 0 3 3 3 3 3 3 3 1 5 5 5
3 3 3 3 3 0 0 0 0 0 0 0 2 2 2 2 2 2 2 3 3 3 3 3 3 2 2 5 5 5
3 3 3 3 3 0 0 0 0 0 0 0 0 0 2 2 2 2 0 3 3 3 3 3 3 2 2 2 5 0
3 3 3 3 3 0 0 0 0 0 0 0 0 0 2 2 2 0 0 3 3 3 3 3 3 2 2 2 0 0
3 3 3 3 3 3 3 3 3 3 3 3 3 3 1 3 3 3 3 3 3 3 3 3 3 2 2 0 0 2
3 3 3 3 3 3 3 3 3 3 3 3 3 1 1 1 3 3 3 3 3 3 3 3 2 2 0 0 2 2
5 2 0 0 3 3 3 3 3 3 3 3 3 1 1 1 3 3 3 3 3 3 3 3 2 2 2 0 2 2
5 2 0 0 3 3 3 3 3 3 3 3 3 1 1 1 3 3 3 3 3 3 3 3 2 2 0 2 0 0
5 2 0 0 3 3 3 3 3 3 3 3 3 1 1 1 3 3 3 3 3 3 2 2 2 0 0 0 0 0
5 2 2 0 3 3 3 3 3 3 3 3 3 1 4 1 3 3 3 0 2 2 2 2 2 0 5 0 0 5
0 0 0 0 3 3 3 3 3 3 3 3 3 3 1 3 3 3 0 0 2 2 2 2 2 0 2 5 5 0
0 0 0 0 3 3 3 3 3 3 3 3 3 6 1 0 0 0 0 0 0 0 2 2 2 0 0 0 0 0
0 0 0 0 3 3 3 3 1 1 1 1 1 1 1 1 7 0 0 0 0 0 0 0 2 0 0 2 2 0
0 0 0 0 0 2 0 0 0 0 6 3 3 0 0 1 8 6 0 0 0 0 6 0 0 0 0 2 0 0
0 0 0 0 2 0 2 0 0 0 0 3 3 0 0 1 1 1 1 1 1 1 1 0 0 0 0 2 2 0
0 0 2 2 2 0 2 2 2 0 0 3 3 0 0 0 0 0 0 6 2 2 1 1 6 0 0 0 2 0
0 0 2 0 2 2 2 0 0 0 0 3 3 0 0 0 0 0 0 5 2 2 2 1 1 0 0 0 0 0
0 2 2 0 0 2 0 0 0 0 0 3 3 3 0 0 0 0 5 5 2 2 2 6 1 1 0 0 0 0
0 2 4 0 0 2 0 0 0 0 0 0 3 3 3 0 0 5 5 5 2 2 2 2 2 1 1 0 2 2
0 2 2 0 0 0 1 1 1 0 0 0 0 3 3 3 0 0 0 5 5 2 2 2 2 0 1 1 0 2
0 0 2 2 2 0 0 0 1 1 0 0 0 3 3 3 0 0 0 5 5 0 0 0 0 0 6 1 0 0
5 0 0 0 2 2 2 2 0 0 0 0 0 1 1 1 0 0 5 5 5 6 0 0 0 0 0 1 1 1
5 5 0 0 0 0 0 0 2 2 0 0 0 1 1 1 0 5 5 5 5 5 5 5 6 2 0 0 0 1
5 5 5 5 5 5 5 5 5 5 0 0 0 3 3 3 5 5 5 5 5 5 5 5 5 2 2 0 0 1
5 5 5 5 5 5 5 5 5 5 0 3 3 3 3 3 3 5 5 5 5 5 5 5 5 5 5 5 5 1